5,0,0,0,0,0,0,0,0,5
5,0,0,0,0,4,0,0,0,5
5,5,5,5,5,5,1,0,0,5
5,0,0,0,0,0,1,0,0,5
5,0,0,0,4,0,1,0,0,5
5,0,0,1,5,5,5,5,5,5
5,0,0,1,0,0,0,0,0,5
5,0,0,1,0,4,0,0,0,5
5,5,5,5,5,5,1,0,0,5
5,0,0,0,0,0,1,0,0,5
5,0,0,0,4,0,1,0,0,5
5,0,0,1,5,5,5,5,5,5
5,0,0,1,0,0,0,0,0,5
5,0,0,1,0,0,0,0,0,5
2,2,2,2,2,2,2,2,2,2